SmaI	cccggg	Blunt
KpnI	ggtacc	Sticky
XhoI	ctcgag	Sticky
BamHI	ggatcc	Sticky
EcoRV	gatatc	Blunt
TaqI	tcga	Sticky
NotI	gcggccgc	Sticky
HinDIII	aagctt	Sticky
HpaI	gttaac	Blunt
PacI	ttaattaa	Sticky
SacI	gagctc	Sticky
PvuI	cgatcg	Sticky
PvuII	cagctg	Blunt
XmaI	cccggg	Sticky
EcoRI	gaattc	Sticky
Bsu15I	atcgat	Sticky
Bsu36I	cct[acgt]agg	Sticky
BsuRI	ggcc	Blunt
EcoRII	cc[at]gg	Sticky

##always use small letters (caps off) for writing the sequence fragment because the fasta file has it in caps off
